#domain
hospital
#levelname
MAAntsStar
#colors
blue: 0, A
red: 1, B
grey: 2, C
green: 3, D
#initial
+++++++++++++
+0        A +
+   +++++++ +
+   +D    + +
+1  + +++ + +
+   +C+ + + +
+   +   + + +
+   +++++ +2+
+   B     +3+
+++++++++ +++
+++++++++++++
#goal
+++++++++++++
+           +
+   +++++++ +
+   +     + +
+   + +++ + +
+   + +A+ + +
+   +   +B+ +
+   +++++ + +
+         + +
+++++++++ +++
+++++++++++++
#end
