#domain
hospital
#levelname
TESTacceess
#colors
blue: 0, A
red: 1,2,3,B,C
#initial
+++++++++++++++++++++++++++++++++++++++++++++++
+                                             +
+ +++++++++++++++++++++++++++++++++++++++++++++
+                                             +
+++++++++++++++++++++++++++++++++++++++++++++ +
+                                             +
+ +++++++++++++++++++++++++++++++++++++++++++++
+                                             +
+++++++++++++++++++++++++++++++++++++++++++++ +
+                                             +
+ +++++++++++++++++++++++++++++++++++++++++++++
+                                             +
+++++++++++++++++++++++++++++++++++++++++++++ +
+   B     3                                   +
+     1      ++++++++++++++++++++++++++++++++++
+ C     2                     A0              +
+++++++++++++++++++++++++++++++++++++++++++++++
#goal
+++++++++++++++++++++++++++++++++++++++++++++++
+                                            A+
+ +++++++++++++++++++++++++++++++++++++++++++++
+                                             +
+++++++++++++++++++++++++++++++++++++++++++++ +
+                                             +
+ +++++++++++++++++++++++++++++++++++++++++++++
+                                             +
+++++++++++++++++++++++++++++++++++++++++++++ +
+                                             +
+ +++++++++++++++++++++++++++++++++++++++++++++
+                                             +
+++++++++++++++++++++++++++++++++++++++++++++ +
+                                             +
+            ++++++++++++++++++++++++++++++++++
+                                             +
+++++++++++++++++++++++++++++++++++++++++++++++
#end
