#domain
hospital
#levelname
MAExample2
#colors
red: 0, A
blue: 1, B
#initial
+++++++++++
+   1+B   +
+    +    +
+    +    +
+    +    +
+    +    +
+    +    +
+    +    +
+         +
+    +    +
+    +    +
+    +    +
+    +    +
+    +    +
+   A+0   +
+++++++++++
#goal
+++++++++++
+    + A  +
+    +    +
+    +    +
+    +    +
+    +    +
+    +    +
+    +    +
+         +
+    +    +
+    +    +
+    +    +
+    +    +
+    +    +
+  B +    +
+++++++++++
#end
