#domain
hospital
#levelname
MAExample2
#colors
red: 0, A
blue: 1, B
#initial
+++++++++++++++++++++
+       B 1 B       +
+                   +
+       A 0 A       +
+++++++++++++++++++++
#goal
+++++++++++++++++++++
+A                 A+
+                   +
+B                 B+
+++++++++++++++++++++
#end
