#domain
hospital
#levelname
SAPearEasy
#colors
red: 0, A, B
#initial
++++++++++++++
+    ABA     +
+    A A     +
+    A0A     +
+    A A     +
+    A A     +
+    A A     +
+    A A     +
++++++ +++++++
++++++ +++++++
++++++++++++++
#goal
++++++++++++++
+            +
+            +
+            +
+            +
+            +
+            +
+            +
++++++A+++++++
++++++B+++++++
++++++++++++++
#end
