#domain
hospital
#levelname
TESTacceess
#colors
blue: 0, A
red: 1, B
#initial
+++++++++++
+01     B +
+         +
+         +
+         +
+         +
++++      +
+A        +
+++++++++++
#goal
+++++++++++
+A       B+
+         +
+         +
+         +
+         +
++++      +
+01       +
+++++++++++
#end