#domain
hospital
#levelname
MAAntsStar
#colors
blue: 0, A
red: 1, B
grey: 2, C
#initial
+++++++++++++
+A        2 +
+   +++++++ +
+B  +     +C+
+1  + +++ + +
+   + + + + +
+   +   + + +
+   +++++ + +
+         +0+
+++++++++ +++
+++++++++++++
#goal
+++++++++++++
+           +
+   +++++++ +
+   +     + +
+   + +++ + +
+   + +A+ + +
+   +   +B+ +
+   +++++ + +
+C        + +
+++++++++ +++
+++++++++++++
#end
