#domain
hospital
#levelname
MAAntsStar
#colors
blue: 0, A
red: 1, B
grey: 2, C
cyan: 3, D
#initial
+++++++++++++
+         2 +
+ D +++++++ +
+B  +     +C+
+1  + +++ + +
+   + + + + +
+   +   + + +
+   +++++ +3+
+     A   +0+
+++++++++ +++
+++++++++++++
#goal
+++++++++++++
+           +
+   +++++++ +
+E  +     + +
+   + +++ + +
+   +D+A+ + +
+   +   +B+ +
+   +++++ + +
+C        + +
+++++++++ +++
+++++++++++++
#end
