#domain
hospital
#levelname
MAAntsStar
#colors
blue: 0, A
red: 1, B
#initial
+++++++++++++
+         1 +
+   +++++++ +
+   +     + +
+   + +++ + +
+   + + + + +
+   +A  + + +
+   +++++ +B+
+         +0+
+++++++++ +++
+++++++++++++
#goal
+++++++++++++
+           +
+   +++++++ +
+   +     + +
+   + +++ + +
+   + +A+ + +
+   +   + + +
+   +++++ + +
+         + +
+++++++++ +++
+++++++++++++
#end
