#domain
hospital
#levelname
MAAntsStar
#colors
blue: 0, A, E
red: 1, B
grey: 2, C
green: 3, D
#initial
+++++++++++++
+A        3 +
+   +++++++ +
+B  +     + +
+1  + +++ + +
+   + + + + +
+   +C  + + +
+0  +++++ +D+
+   E     +2+
+++++++++ +++
+++++++++++++
#goal
+++++++++++++
+           +
+   +++++++ +
+   +     + +
+   + +++ + +
+   + +A+ + +
+   +   +B+ +
+   +++++ + +
+         + +
+++++++++ +++
+++++++++++++
#end
