#domain
hospital
#levelname
MAAntsStar
#colors
blue: 0, A, E
red: 1, B
grey: 2, C
green: 3, D
cyan: 4, F
#initial
+++++++++++++
+A   F    3 +
+   +++++++ +
+B  +     + +
+1  + +++ + +
+   +4+ + + +
+   +C  + + +
+0  +++++ +D+
+   E     +2+
+++++++++ +++
+++++++++++++
#goal
+++++++++++++
+           +
+   +++++++ +
+C  +     + +
+E  + +++ + +
+D  + +A+ + +
+F  +   +B+ +
+   +++++ + +
+         + +
+++++++++ +++
+++++++++++++
#end
