#domain
hospital
#levelname
TESTacceess
#colors
blue: 0, A
red: 1
#initial
+++++++++++
+      A+0+
+     +++1+
+         +
+         +
+       + +
+       + +
+++++++++++
#goal
+++++++++++
+       + +
+     +++ +
+         +
+         +
+       + +
+A      + +
+++++++++++
#end
