#domain
hospital
#levelname
TESTacceess
#colors
blue: 0, A
red: 1, B
#initial
+++++++++++
+0  A     +
+ A     +++
+         +
+       +++
+    A  AB+
+      A+++
+A    AAA1+
+++++++++++
#goal
+++++++++++
+         +
+       +++
+        B+
+       +++
+         +
+       +++
+         +
+++++++++++
#end
