#domain
hospital
#levelname
TESTacceess
#colors
blue: 0, A
red: 1, B
green: 2, C
orange: 3
#initial
+++++++++++
+0    BC+2+
+     +++3+
+         +
+        A+
+       + +
+       +1+
+++++++++++
#goal
+++++++++++
+       + +
+     +++ +
+         +
+         +
+       + +
+       +C+
+++++++++++
#end
